10
####.....#
...#.###.#
##.#...#.#
.#.###.#.G
.#.....###
...###....
.#...#####
.###...#..
.#.###.#.#
S#........
