8
S#.##...
.#..#.#G
.##.#.##
....#...
.####.##
........
###.###.
....#...
