15
..........S#.#.
.#.#####.###.#.
.#.#...........
.#.#.#########.
.#.#.#.#.#.....
.#.....#.#.#.#.
.#####.#.###.#.
.......#.....#.
####.###.###.#.
..........#..#.
###.##########.
........#......
.##.###.#.#.#..
.##.#.#...#.###
.G#.#...###....
