20
S#######...........#
.........#.#######.#
.##.######...#...#.#
.....#.#####.#.#.#.#
.#.##....#.#.#.#....
.#.##.##.#...#.#.##.
.#.##.##.#.#.#.#.##.
...............#.##.
##.#########.###....
##.#.###...#.....#.#
...#.....#.###.###.#
.#.##.####...#.....#
.#.......#.#.####.##
.#.#####.#.#........
.#.#####.#.###.####.
.#.....#.#.#....#G#.
.#.###.#.#...####.#.
...#...#.#####..#...
#.######....###.####
.........##........#
