20
S#.#....#...........
.#.#.##.#.#.#######.
...#..#.#.#.#.......
.#.####.###.#.###.#.
.#..........#.#.#.##
.#.#.###.####.#.#...
.#.#.#...#....#.#.#.
.#.#.#.###.####.#.#.
.#.#.......#....#.#.
...#.#.###.###.##.#.
##.#.#.#.....#....#.
...#.#.#.#.###.####.
.###.#.###.#........
...........#.###.#.#
######.###.#.#.#.#.#
.....#.#.#.....###.#
.###.#.#.#.#####.#.#
.#...#.#.........#.#
.#####.#.###.#####.#
.......#.#...#G....#
