30
S#.#....#.....................
.#.#.##.#.#.#######.#.#######.
...#..#.#.#.#.......#.#....##.
.#.####.###.#.###.#.#.#.##.##.
.#..........#.#.#.###.#.##.##.
.#.#.###.####.#.#...........#.
.#.#.#...#....#.#.#.#.#####.#.
.#.#.#.###.####.#.#.#.#.#.#.#.
.#.#.......#....#.#.#.#.#.#.#.
...#.#.###.###.##.#.###.#.#.#.
##.#.#.#.....#....#.......#.#.
...#.#.#.#.###.####.####.##.#.
.###.#.###.#........#.#.......
...........#.###.#.##.#.####.#
######.###.#.#.#.#.#..#.#..#.#
.....#.#.#.....###.#.##.##.#..
.###.#.#.#.#####.#.#.#...#.#.#
.#...#.#.........#.#.#.#.#.#..
.#####.#.###.#####...#.#.#.##.
.......#.#...#.....#.#.#.#....
##.#####.###.##.####...#.##.#.
.#.#.............#...#.#..#.#.
.#.#.###.#####.###.###.##...#.
...#.#.#.#...#.#...#.......##.
.###.#.#.###...#.###.#####.#..
.....#...#.#.#.#.....#.#.#.###
##.###.###.###.#.###.#.#.#....
.#.....#...#.#.#.#.#.#.#...###
.#.##.##.###.#.#.#.#.#.###.##G
...#.....#.......#...#.#......
