30
.#.#....#....................G
.#.#.##.#.#.#######.#.#######.
...#..#.#.#.#.......#.#....##.
.#.####.###.#.###.#.#.#.##....
.#..........#.#.#.###.#.##.##.
.#.#.###.####.#.#...........#.
.#.#.#...#....#.#.#.#.#####.#.
.#.#.#.###.####.#.#.#.#.#.#.#.
.#.#.......#....#.#.#.#.#.#.#.
...#.#.###.###.##.#.###.#.#.#.
##.#.#.#.....#....#.......#.#.
...#.#.#.#.###.####.####.##.#.
.###.#.###.#........#.#.......
...........#.###.#.##.#.####.#
######.###.#.#.#.#.#..#.#..#.#
.....#.#.#.....###.#.##.##.#..
.###.#.#.#.#####.#.#.#...#.#.#
.#...#.#.........#.#.#.#.#.#..
.#####.#.###.#####...#.#.#.##.
.......#.#...#.....#.#.#.#....
##.#####.###.##.####...#.##.#.
.#.#.............#...#.#..#.#.
.#.#.###.#####.###.###.##.#.#.
...#.#.#.#...#.#...#......###.
.###.#.#.###...#.###.#######..
.....#...#.#.#.#.....#.#.#.###
##.###.###.###.#.###.#.#.#....
S#.....#...#.#.#.#.#.#.#...###
.#.##.##.###.#.#.#.#.#.###.##.
...#.............#...#.#......
