40
S#.#....#.....................###.......
.#.#.##.#.#.#######.#.#######.#...#####.
...#..#.#.#.#.......#.#....##...###...#.
.#.####.###.#.###.#.#.#.##.##.#.#...#...
.#..........#.#.#.###.#.##.##.#...#####.
.#.#.###.####.#.#...........#.#.###.....
.#.#.#...#....#.#.#.#.#####.#.#.....#.#.
.#.#.#.###.####.#.#.#.#.#.#.#.#.###.#.#.
.#.#.......#....#.#.#.#.#.#.#.#...#.#.##
...#.#.###.###.##.#.###.#.#.#.#.###.#...
##.#.#.#.....#....#.......#.#.#.#...#.#.
...#.#.#.#.###.####.####.##.#.#.#####.#.
.###.#.###.#........#.#.......#.......#.
...........#.###.#.##.#.####.##.###.###.
######.###.#.#.#.#.#..#.#..#.#..#.......
.....#.#.#.....###.#.##.##.#...##.#####.
.###.#.#.#.#####.#.#.#...#.#.###......#.
.#...#.#.........#.#.#.#.#.#..#..######.
.#####.#.###.#####...#.#.#.##.#.##......
.......#.#...#.....#.#.#.#....#.#..#####
##.#####.###.##.####...#.##.#.#...##....
.#.#.............#...#.#..#.#.#.#.#..#.#
.#.#.###.#####.###.###.##.#.#.###.#.##.#
...#.#.#.#...#.#...#......###.###.#.#..#
.###.#.#.###...#.###.#######...##.#.#.##
.....#...#.#.#.#.....#.#.#.###....#.#.##
##.###.###.###.#.###.#.#.#.....#.##.#.##
.#.....#...#.#.#.#.#.#.#...###.#.#..#.##
.#.##.##.###.#.#.#.#.#.###.##..#.####.##
...#.....###.....#...#.#......##......##
.#...###.....#.#.#.#...###.#.########.##
.###.#.#.###.#.#.#.#.#.#...#........#...
.....#.#.#.#.#.#.#.#.#...##########.####
.#.#.#...#.#.###.###.#.#...#.#....#.#...
.#.#.###.#.#.........#.#.###.#.##.#.#.##
.#.#.....#.##.########.#.#.....##.#.#.#G
.#.#.###.#.........#...#.#.###.####...#.
.#.#...#.##.###.##.##.##.#.#.#.##...#...
.###.#.#..#.###.##....##.#.#.#.######.#.
.....#.####.....##.#####.#.#.#........#.
