40
S#.#....#.....................###.......
.#.#.##.#.#.#######.#.#######.#...#####.
...#..#.#.#.#.......#.#....##...###...#.
.#.####.###.#.###.#.#.#.##.##.#.#...#...
.#..........#.#.#.###.#.##.##.#...#####.
.#.#.###.####.#.#...........#.#.###.....
.#.#.#...#....#.#.#.#.#####.#.#.....#.#.
.#.#.#.###.####.#.#.#.#.#.#.#.#.###.#.#.
.#.#.......#....#.#.#.#.#.#.#.#...#.#.##
...#.#.###.###.##.#.###.#.#.#.#.###.#...
##.#.#.#.....#....#.......#.#.#.#...#.#.
...#.#.#.#.###.####.####.##.#.#.#####.#.
.###.#.###.#........#.#.......#.......#.
...........#.###.#.##.#.####.##.###.###.
######.###.#.#.#.#.#..#.#..#.#..#.......
.....#.#.#.....###.#.##.##.#...##.#####.
.###.#.#.#.#####.#.#.#...#.#.###......#.
.#...#.#.........#.#.#.#.#.#..#..######.
.#####.#.###.#####...#.#.#.##.#.##......
.......#.#...#.....#.#.#.#....#.#..#####
##.#####.###.##.####...#.##.#.#...##....
.#.#.............#...#.#..#.#.#.#.#..#.#
.#.#.###.#####.###.###.##...#.###.#.##.#
...#.#.#.#...#.#...#.......##.###.#.#..#
.###.#.#.###...#.###.#####.#...##.#.#.##
.....#...#.#.#.#.....#.#.#.###....#.#.##
##.###.###.###.#.###.#.#.#.....#.##.#.##
.#.....#...#.#.#.#.#.#.#...###.#.#..#.##
.#.##.##.###.#.#.#.#.#.###.##..#.####.##
...#.....#.......#...#.#......##......##
.#...###.....#.#.#.#...###.#.########.#.
.###.#.#.###.#.#.#.#.#.#...#............
.....#.#.#.#.#.#.#.#.#...##########.####
.#.#.#...#.#.###.###.#.#...#.#....#.#...
.#.#.###.#.#.........#.#.###.#.##.#.#.#.
.#.#.....#.##.########.#.#.....##.#.#.#.
.#.#.###.#.........#...#.#.###.####...#.
.#.#...#.##.###.##.##.##.#.#.#.##...#.#.
.###.#.#..#.###.##....##.#.#.#.######.#.
.....#.####........#####.....#........#G
