45
S#.#....#.....................###............
.#.#.##.#.#.#######.#.#######.#...#####.####.
...#..#.#.#.#.......#.#....##...###...#....#.
.#.####.###.#.###.#.#.#.##.##.#.#...#...####.
.#..........#.#.#.###.#.##.##.#...#####.#....
.#.#.###.####.#.#...........#.#.###.....#.#.#
.#.#.#...#....#.#.#.#.#####.#.#.....#.#.#.#.#
.#.#.#.###.####.#.#.#.#.#.#.#.#.###.#.#...#.#
.#.#.......#....#.#.#.#.#.#.#.#...#.#.##.##.#
...#.#.###.###.##.#.###.#.#.#.#.###.#.......#
##.#.#.#.....#....#.......#.#.#.#...#.#.###..
...#.#.#.#.###.####.####.##.#.#.#####.#.#.##.
.###.#.###.#........#.#.......#.......#.#....
...........#.###.#.##.#.####.##.###.###.#.##.
######.###.#.#.#.#.#..#.#..#.#..#.......#.#..
.....#.#.#.....###.#.##.##.#...##.#####.#.#.#
.###.#.#.#.#####.#.#.#...#.#.###......#.###.#
.#...#.#.........#.#.#.#.#.#..#..######.....#
.#####.#.###.#####...#.#.#.##.#.##......##.##
.......#.#...#.....#.#.#.#....#.#..######....
##.#####.###.##.####...#.##.#.#...##......##.
.#.#.............#...#.#..#.#.#.#.#..#.#####.
.#.#.###.#####.###.###.##.#.#.###.#.##.#.....
...#.#.#.#...#.#...#......###.###.#.#..#.#.#.
.###.#.#.###...#.###.#######...##.#.#.##.#.#.
.....#...#.#.#.#.....#.#.#.###....#.#.##.###.
##.###.###.###.#.###.#.#.#.....#.##.#.##.#...
.#.....#...#.#.#.#.#.#.#...###.#.#..#.##.#.#.
.#.##.##.###.#.#.#.#.#.###.##..#.####.##.#.#.
...#.....###.....#...#.#......##......##.#.#.
.#...###.....#.#.#.#...###.#.########.##.#.#.
.###.#.#.###.#.#.#.#.#.#...#........#....#.#.
.....#.#.#.#.#.#.#.#.#...##########.####.###.
.#.#.#...#.#.###.###.#.#...#.#....#.#....#...
.#.#.###.#.#.........#.#.###.#.##.#.#.####.##
.#.#.....#.##.########.#.#.....##.#.#.#....#.
.#.#.###.#.........#...#.#.###.####...#.####.
.#.#...#.##.###.##.##.##.#.#.#.##...#.#....#.
.###.#.#..#.###.##....##.#.#.#.######.####...
.....#.####.....##.#####.#.#.#........#....##
##.#........###.##.......###...######...####G
.#...##########.##.#.###.#...###....#.#.#....
.#.#.#..........#....#.#...#.....####.#.#.###
.#.#.###.###.####.####.#.###.###.#.##.#.#.###
...#.....###.#....#......#...#...#.##.#.....#
