55
.#.#....#.....................###.....................S
.#.#.##.#.#.#######.#.#######.#...#####.####.##########
...#..#.#.#.#.......#.#....##...###...#....#.....#.....
.#.####.###.#.###.#.#.#.##.##.#.#...#...####.#########.
.#..........#.#.#.###.#.##.##.#...#####.#.........#....
.#.#.###.####.#.#...........#.#.###.....#.#.#####.####.
.#.#.#...#....#.#.#.#.#####.#.#.....#.#.#.#.#........#.
.#.#.#.###.####.#.#.#.#.#.#.#.#.###.#.#...#.#.#.######.
.#.#.......#....#.#.#.#.#.#.#.#...#.#.##.##.#.#.#......
...#.#.###.###.##.#.###.#.#.#.#.###.#.......#.#.#.####.
##.#.#.#.....#....#.......#.#.#.#...#.#.###...#.#.#....
...#.#.#.#.###.####.####.##.#.#.#####.#.#.##.##.#.#.#.#
.###.#.###.#........#.#.......#.......#.#....##.###.#.#
...........#.###.#.##.#.####.##.###.###.#.##.##.....#.#
######.###.#.#.#.#.#..#.#..#.#..#.......#.#...#.#.###.#
.....#.#.#.....###.#.##.##.#...##.#####.#.#.#.#.#.#...#
.###.#.#.#.#####.#.#.#...#.#.###......#.###.#.#.#.###.#
.#...#.#.........#.#.#.#.#.#..#..######.....#.#.#......
.#####.#.###.#####...#.#.#.##.#.##......##.##.###.###.#
.......#.#...#.....#.#.#.#....#.#..######.........#.#.#
##.#####.###.##.####...#.##.#.#...##......##.#.####.#.#
.#.#.............#...#.#..#.#.#.#.#..#.#####.#........#
.#.#.###.#####.###.###.##.#.#.###.#.##.#.....#.######.#
...#.#.#.#...#.#...#......###.###.#.#..#.#.#.#........#
.###.#.#.###...#.###.#######...##.#.#.##.#.#.#.########
.....#...#.#.#.#.....#.#.#.###....#.#.##.###.#.........
##.###.###.###.#.###.#.#.#.....#.##.#.##.#...#.######.#
.#.....#...#.#.#.#.#.#.#...###.#.#..#.##.#.#.#.#..###.#
.#.##.##.###.#.#.#.#.#.###.##..#.####.##.#.#.#.#.####.#
...#.....###.....#...#.#......##......##.#.#.#.#.####.#
.#...###.....#.#.#.#...###.#.########.##.#.#.#......#.#
.###.#.#.###.#.#.#.#.#.#...#........#....#.#.########.#
.....#.#.#.#.#.#.#.#.#...##########.####.###.#........#
.#.#.#...#.#.###.###.#.#...#.#....#.#....#...####.###.#
.#.#.###.#.#.........#.#.###.#.##.#.#.####.####.#......
.#.#.....#.##.########.#.#.....##.#.#.#....#....#.#.###
.#.#.###.#.........#...#.#.###.####...#.####.####.#.#..
.#.#...#.##.###.##.##.##.#.#.#.##...#.#....#......#.###
.###.#.#..#.###.##....##.#.#.#.######.####...##.###.#..
.....#.####.....##.#####.#.#.#........#....###..#...#.#
##.#........###.##.......###...######...####...##.#.#..
.#...##########.##.#.###.#...###....#.#.#....#.#..#.##.
.#.#.#..........#....#.#...#.....####.#.#.####.####....
.#.#.###.###.####.####.#.###.###.#.##.#.#.####...######
...#.....###.#....#......#...#...#.##.#.....####.......
.#.#.#.#.....#.#.##.###.##.#.#.#.#.##...#.#.####.###.##
.#.#.#.#.###.#.#.#..#.#.##.#...#.#.##.#.#.#.###.......#
.#.#.#.#.###.###.#.##.#....##.##......#.###.##..#####..
.#.#.#.#.#.#.....#.#....#.##.....#.####.#......#######.
.#...#.#.#.#.#.###.####.#....##.##......#.####.#######.
.#.#.#.#.#.###.##..#.#..#.#.###.#..#.#.##.#..#.#######.
.#.#.#.#.#...#.#..##.#.##.#.#.#.#.##.#.##.##.#.#######.
.#.#.###.#.#.#.#.##..#.#..#.#.#.#.#..#.#.......#######.
##.#.###...#.#.#.##.##.#.##.#.#.#.####.#.#####..#####..
G..#####.###.###....#..#....#.#.#..........####.......#
