55
.#.#....#.....................###.....................S
.#.#.##.#.#.#######.#.#######.#...#####.####.##########
...#..#.#.#.#.......#.#....##...###...#....#.....#.....
.#.####.###.#.###.#.#.#.##.##.#.#...#...####.#########.
.#..........#.#.#.###.#.##.##.#...#####.#.........#....
.#.#.###.####.#.#...........#.#.###.....#.#.#####.####.
.#.#.#...#....#.#.#.#.#####.#.#.....#.#.#.#.#........#.
.#.#.#.###.####.#.#.#.#.#.#.#.#.###.#.#...#.#.#.######.
.#.#.......#....#.#.#.#.#.#.#.#...#.#.##.##.#.#.#......
...#.#.###.###.##.#.###.#.#.#.#.###.#.......#.#.#.####.
##.#.#.#.....#....#.......#.#.#.#...#.#.###...#.#.#....
...#.#.#.#.###.####.####.##.#.#.#####.#.#.##.##.#.#.#.#
.###.#.###.#........#.#.......#.......#.#....##.###.#.#
...........#.###.#.##.#.####.##.###.###.#.##.##.....#.#
######.###.#.#.#.#.#..#.#..#.#..#.......#.#...#.#.###.#
.....#.#.#.....###.#.##.##.#...##.#####.#.#.#.#.#.#...#
.###.#.#.#.#####.#.#.#...#.#.###......#.###.#.#.#.###.#
.#...#.#.........#.#.#.#.#.#..#..######.....#.#.#......
.#####.#.###.#####...#.#.#.##.#.##......##.##.###.###.#
.......#.#...#.....#.#.#.#....#.#..######.........#.#.#
##.#####.###.##.####...#.##.#.#...##......##.#.####.#.#
.#.#.............#...#.#..#.#.#.#.#..#.#####.#........#
.#.#.###.#####.###.###.##...#.###.#.##.#.....#.######.#
...#.#.#.#...#.#...#.......##.###.#.#..#.#.#.#........#
.###.#.#.###...#.###.#####.#...##.#.#.##.#.#.#.########
.....#...#.#.#.#.....#.#.#.###....#.#.##.###.#.........
##.###.###.###.#.###.#.#.#.....#.##.#.##.#...#.######.#
.#.....#...#.#.#.#.#.#.#...###.#.#..#.##.#.#.#.#..###.#
.#.##.##.###.#.#.#.#.#.###.##..#.####.##.#.#.#.#.####.#
...#.....#.......#...#.#......##......##.#.#.#.#.####.#
.#...###.....#.#.#.#...###.#.########.#..#.#.#......#.#
.###.#.#.###.#.#.#.#.#.#...#........#....#.#.########.#
.....#.#.#.#.#.#.#.#.#...##########.####.###.#........#
.#.#.#...#.#.###.###.#.#...#.#....#.#....#...####.###.#
.#.#.###.#.#.........#.#.###.#.##.#.#.####.###..#......
.#.#.....#.##.########.#.#.....##.#.#.#....#....#.#.###
.#.#.###.#.........#...#.#.###.####...#.####.####.#.#..
.#.#...#.##.###.##.##.##.#.#.#.##...#.#....#......#.##.
.###.#.#..#.###.##....##.#.#.#.######.####...##.###.#..
.....#.####.....##.#####.#.#.#........#....###..#...#.#
##.#........###.##.......###...######...####...##.#.#..
.#...##########.##.#.###.#...###....#.#.#....#.#..#.##.
.#.#.#..........#....#.#...#.....####.#.#.####.####....
.#.#.###.###.####.####.#.###.###.#.##.#.#.####....#####
...#.....#...#....#......#...#...#.##.#.....####.......
.#.#.#.#.....#.#.##.###.##.#.#.#.#.##...#.#.####.###.##
.#.#.#.#.###.#.#.#..#.#.##.#...#.#.##.#.#.#.###.......#
.#.#.#.#.###.###.#.##.#....##.##......#.###.#...#####..
.#.#.#.#.#.#.....#.#....#.##.....#.####.#......#######.
.#...#.#.#.#.#.###.#.##.#....##.##......#.####.#######.
.#.#.#.#.#.###.##..#.#..#.#.###.#..#.#.##.#..#.#######.
.#.#.#.#.#...#.#..##.#.##.#.#.#.#.##.#.#..##.#.#######.
G#.#.###.#.#.#.#.##..#.#..#.#.#.#.#..#.#.......#######.
##.#.###...#.#.#.##.##.#.##.#.#.#.####.#.#####..#####..
...#...#.###........#..#....#................##.......#
