64
.#.#....#.....................###.......................#.......
.#.#.##.#.#.#######.#.#######.#...#####.####.##########.#.#####.
...#..#.#.#.#.......#.#....##...###...#....#.....#......#.....#.
.#.####.###.#.###.#.#.#.##.##.#.#...#...####.#########.##.###.##
.#..........#.#.#.###.#.##.##.#...#####.#.........#.......#.....
.#.#.###.####.#.#...........#.#.###.....#.#.#####.####.####.##.#
.#.#.#...#....#.#.#.#.#####.#.#.....#.#.#.#.#........#.#....#..#
.#.#.#.###.####.#.#.#.#.#.#.#.#.###.#.#...#.#.#.######.###.##.##
.#.#.......#....#.#.#.#.#.#.#.#...#.#.##.##.#.#.#......#.#.#..#.
...#.#.###.###.##.#.###.#.#.#.#.###.#.......#.#.#.####.#.#.#.##.
##.#.#.#.....#....#.......#.#.#.#...#.#.###...#.#.#......#.#.##.
...#.#.#.#.###.####.####.##.#.#.#####.#.#.##.##.#.#.#.#.##.#.##.
.###.#.###.#........#.#.......#.......#.#....##.###.#.#.#..#....
...........#.###.#.##.#.####.##.###.###.#.##.##.....#.#.####.###
######.###.#.#.#.#.#..#.#..#.#..#.......#.#...#.#.###.#......#..
.....#.#.#.....###.#.##.##.#...##.#####.#.#.#.#.#.#...#.#.#.##..
.###.#.#.#.#####.#.#.#...#.#.###......#.###.#.#.#.###.#.#.#.....
.#...#.#.........#.#.#.#.#.#..#..######.....#.#.#.......#.#####.
.#####.#.###.#####...#.#.#.##.#.##......##.##.###.###.#.#...#...
.......#.#...#.....#.#.#.#....#.#..######.........#.#.###.###.##
##.#####.###.##.####...#.##.#.#...##......##.#.####.#.#...#...##
S#.#.............#...#.#..#.#.#.#.#..#.#####.#........#.#.#.#.##
.#.#.###.#####.###.###.##...#.###.#.##.#.....#.######.#.#.#.####
...#.#.#.#...#.#...#.......##.###.#.#..#.#.#.#........#.#.#.....
.###.#.#.###...#.###.#####.#...##.#.#.##.#.#.#.########.#.##.#.#
.....#...#.#.#.#.....#.#.#.###....#.#.##.###.#..........#..#.#.#
##.###.###.###.#.###.#.#.#.....#.##.#.##.#...#.######.#.####.#.#
.#.....#...#.#.#.#.#.#.#...###.#.#..#.##.#.#.#.#..###.#...#..#.#
.#.##.##.###.#.#.#.#.#.###.##..#.####.##.#.#.#.#.####.###.#.##.#
...#.....#.......#...#.#......##......##.#.#.#.#.####.#...#.#..#
.#...###.....#.#.#.#...###.#.########.#..#.#.#......#.#.###.#..#
.###.#.#.###.#.#.#.#.#.#...#........#....#.#.########.#.#...#.##
.....#.#.#.#.#.#.#.#.#...##########.####.###.#........#.#.###.#.
.#.#.#...#.#.###.###.#.#...#.#....#.#....#...####.###.#.#.#...#.
.#.#.###.#.#.........#.#.###.#.##.#.#.####.###..#.......#.#.###.
.#.#.....#.##.########.#.#.....##.#.#.#....#....#.#.###.#.#.#...
.#.#.###.#.........#...#.#.###.####...#.####.####.#.#.....#.#.#.
.#.#...#.##.###.##.##.##.#.#.#.##...#.#....#......#.#####.#.#.#.
.###.#.#..#.###.##....##.#.#.#.######.####...##.###.#.....#.#G#.
.....#.####.....##.#####.#.#.#........#....###..#...#.##.##.###.
##.#........###.##.......###...######...####...##.#.#..#........
.#...##########.##.#.###.#...###....#.#.#....#.#..#.##.##.#####.
.#.#.#..........#....#.#...#.....####.#.#.####.####.....#.###...
.#.#.###.###.####.####.#.###.###.#.##.#.#.####....#####.#.....##
...#.....#...#....#......#...#...#.##.#.....####........##.#####
.#.#.#.#.....#.#.##.###.##.#.#.#.#.##...#.#.####.###.##..#.....#
.#.#.#.#.###.#.#.#..#.#.##.#...#.#.##.#.#.#.###.......##.#.###..
.#.#.#.#.###.###.#.##.#....##.##......#.###.##..#####..#.#.#.##.
.#.#.#.#.#.#.....#.#....#.##.....#.####.#......#######.#.#.#..#.
.#...#.#.#.#.#.###.#.##.#....##.##......#.####.#######.#.#.##.#.
.#.#.#.#.#.###.##..#.#..#.#.###.#..#.#.##.#..#.#######.#.#.##.#.
.#.#.#.#.#...#.#..##.#.##.#.#.#.#.##.#.#..##.#.#######.#.#....#.
.#.#.###.#.#.#.#.##..#.#..#.#.#.#.#..#.#.......#######.#.#.####.
##.#.###...#.#.#.##.##.#.##.#.#.#.####.#.#####..#####..#.#......
...#...#.###...#....#..#....#.#.#..........####.......##.#.###..
.#...............#....##.##.....#.##.###.#......#######..#...##.
.#####.#####.##.##.#####.#####.##.##.###.#.####...#.....##.#....
...#.....#...##.##.#.#.#.#####.##.##.#.#.#.#.##.#.########.##.##
.#.#.###.#.#.#..##.#.#.#.......#...#.#.....#....#.#...........#.
.#.#...#.#.#.#####.#.#.#.#####.#.#.#.###.#.####.#...###.###.#.#.
.#.#.###.#.#.#...#.#...#.......#.###.###.#.#....#.#.###.#.#.#.#.
.#.#.#...#.#.#.#.#.#.###.###.#.#.....#.....#.##...#.##..#.#.#.#.
.#.#.#.#####.#.###.#.#.#.#...#.#####.#####.####.#.#..#.##.#.###.
.....#.......#...........#.###.......#..........####.#....#.....
