64
.#.#....#.....................###.......................#.......
.#.#.##.#.#.#######.#.#######.#...#####.####.##########.#.#####.
...#..#.#.#.#.......#.#....##...###...#....#.....#......#.....#.
.#.####.###.#.###.#.#.#.##.##.#.#...#...####.#########.##.###.##
.#..........#.#.#.###.#.##.##.#...#####.#.........#.......#.....
.#.#.###.####.#.#...........#.#.###.....#.#.#####.####.####.##.#
.#.#.#...#....#.#.#.#.#####.#.#.....#.#.#.#.#........#.#....#..#
.#.#.#.###.####.#.#.#.#.#.#.#.#.###.#.#...#.#.#.######.###.##.##
.#.#.......#....#.#.#.#.#.#.#.#...#.#.##.##.#.#.#......#.#.#..#.
...#.#.###.###.##.#.###.#.#.#.#.###.#.......#.#.#.####.#.#.#.##.
##.#.#.#.....#....#.......#.#.#.#...#.#.###...#.#.#......#.#.##.
...#.#.#.#.###.####.####.##.#.#.#####.#.#.##.##.#.#.#.#.##.#.##.
.###.#.###.#........#.#.......#.......#.#....##.###.#.#.#..#....
...........#.###.#.##.#.####.##.###.###.#.##.##.....#.#.####.###
######.###.#.#.#.#.#..#.#..#.#..#.......#.#...#.#.###.#......#..
.....#.#.#.....###.#.##.##.#...##.#####.#.#.#.#.#.#...#.#.#.##.#
.###.#.#.#.#####.#.#.#...#.#.###......#.###.#.#.#.###.#.#.#.....
.#...#.#.........#.#.#.#.#.#..#..######.....#.#.#.......#.#####.
.#####.#.###.#####...#.#.#.##.#.##......##.##.###.###.#.#...#...
.......#.#...#.....#.#.#.#....#.#..######.........#.#.###.###.##
##.#####.###.##.####...#.##.#.#...##......##.#.####.#.#...#...##
S#.#.............#...#.#..#.#.#.#.#..#.#####.#........#.#.#.#.##
.#.#.###.#####.###.###.##.#.#.###.#.##.#.....#.######.#.#.#.####
...#.#.#.#...#.#...#......###.###.#.#..#.#.#.#........#.#.#.....
.###.#.#.###...#.###.#######...##.#.#.##.#.#.#.########.#.##.#.#
.....#...#.#.#.#.....#.#.#.###....#.#.##.###.#..........#..#.#.#
##.###.###.###.#.###.#.#.#.....#.##.#.##.#...#.######.#.####.#.#
.#.....#...#.#.#.#.#.#.#...###.#.#..#.##.#.#.#.#..###.#...#..#.#
.#.##.##.###.#.#.#.#.#.###.##..#.####.##.#.#.#.#.####.###.#.##.#
...#.....###.....#...#.#......##......##.#.#.#.#.####.#...#.##.#
.#...###.....#.#.#.#...###.#.########.##.#.#.#......#.#.###.#..#
.###.#.#.###.#.#.#.#.#.#...#........#....#.#.########.#.#...#.##
.....#.#.#.#.#.#.#.#.#...##########.####.###.#........#.#.###.#.
.#.#.#...#.#.###.###.#.#...#.#....#.#....#...####.###.#.#.#...#.
.#.#.###.#.#.........#.#.###.#.##.#.#.####.####.#.......#.#.###.
.#.#.....#.##.########.#.#.....##.#.#.#....#....#.#.###.#.#.#...
.#.#.###.#.........#...#.#.###.####...#.####.####.#.#.....#.#.#.
.#.#...#.##.###.##.##.##.#.#.#.##...#.#....#......#.#####.#.#.#.
.###.#.#..#.###.##....##.#.#.#.######.####...##.###.#.....#.#G#.
.....#.####.....##.#####.#.#.#........#....###..#...#.##.##.###.
##.#........###.##.......###...######...####...##.#.#..#........
.#...##########.##.#.###.#...###....#.#.#....#.#..#.##.##.#####.
.#.#.#..........#....#.#...#.....####.#.#.####.####.....#.###...
.#.#.###.###.####.####.#.###.###.#.##.#.#.####...######.#.....##
...#.....###.#....#......#...#...#.##.#.....####........##.#####
.#.#.#.#.....#.#.##.###.##.#.#.#.#.##...#.#.####.###.##..#.....#
.#.#.#.#.###.#.#.#..#.#.##.#...#.#.##.#.#.#.###.......##.#.###..
.#.#.#.#.###.###.#.##.#....##.##......#.###.##..#####..#.#.#.##.
.#.#.#.#.#.#.....#.#....#.##.....#.####.#......#######.#.#.#..#.
.#...#.#.#.#.#.###.####.#....##.##......#.####.#######.#.#.##.#.
.#.#.#.#.#.###.##..#.#..#.#.###.#..#.#.##.#..#.#######.#.#.##.#.
.#.#.#.#.#...#.#..##.#.##.#.#.#.#.##.#.##.##.#.#######.#.#....#.
.#.#.###.#.#.#.#.##..#.#..#.#.#.#.#..#.#.......#######.#.#.#####
##.#.###...#.#.#.##.##.#.##.#.#.#.####.#.#####..#####..#.#.....#
...#####.###.###....#..#....#.#.#..........####.......##.#.###..
.#...............#.##.##.##.....#.##.###.#......#######..#...##.
.#####.#####.##.##.#####.#####.##.##.###.#.####...#.....##.#....
...#.....#...##.##.#.#.#.#####.##.##.#.#.#.#.##.#.########.##.##
.#.#.###.#.#.#..##.#.#.#.......#...#.#.....#....#.#...........#.
.#.#...#.#.#.#####.#.#.#.#####.#.#.#.###.#.####.#...###.###.#.#.
.#.#.###.#.#.#...#.#...#.......#.###.###.#.#....#.#.###.#.#.#.#.
.#.#.#...#.#.#.#.#.#.###.###.#.#.....#.....#.##...#.##..#.#.#.#.
.#.#.#.#####.#.###.#.#.#.#...#.#####.#####.####.#.#..#.##.#.###.
.....#.......#...........#.###.......#..........####.#....#.....
