10
...##....S
##..#####.
####......
....##.##.
.##.#.....
.#..#####.
.#.#####..
.#.....#.#
.#.###.#.#
G..#...###